schwach: maskulin nominativ	-e	
schwach: feminin nominativ	-e	
schwach: neutrum nominativ	-e	
schwach: plural nominativ	-en	
schwach: maskulin akkusativ	-en	
schwach: feminin akkusativ	-e	
schwach: neutrum akkusativ	-e	
schwach: plural akkusativ	-en	
schwach: maskulin genitiv	-en	
schwach: feminin genitiv	-en	
schwach: neutrum genitiv	-en	
schwach: plural genitiv	-en	
schwach: maskulin dativ	-en	
schwach: feminin dativ	-en	
schwach: neutrum dativ	-en	
schwach: plural dativ	-en	
gemischt: maskulin nominativ	-er	leech
gemischt: feminin nominativ	-e	
gemischt: neutrum nominativ	-es	
gemischt: plural nominativ	-en	
gemischt: maskulin akkusativ	-en	
gemischt: feminin akkusativ	-e	
gemischt: neutrum akkusativ	-es	
gemischt: plural akkusativ	-en	
gemischt: maskulin genitiv	-en	
gemischt: feminin genitiv	-en	
gemischt: neutrum genitiv	-en	
gemischt: plural genitiv	-en	
gemischt: maskulin dativ	-en	
gemischt: feminin dativ	-en	
gemischt: neutrum dativ	-en	
gemischt: plural dativ	-en	
stark: maskulin nominativ	-er	
stark: feminin nominativ	-e	
stark: neutrum nominativ	-es	
stark: plural nominativ	-e	
stark: maskulin akkusativ	-en	
stark: feminin akkusativ	-e	
stark: neutrum akkusativ	-es	
stark: plural akkusativ	-e	
stark: maskulin genitiv	-en	
stark: feminin genitiv	-er	
stark: neutrum genitiv	-en	
stark: plural genitiv	-er	leech
stark: maskulin dativ	-em	
stark: feminin dativ	-er	
stark: neutrum dativ	-em	
stark: plural dativ	-en	